
NUMPOLLIES 36

//XYZUV
//tla veliki kvadrat
7	0	0		0	0		0	1	0
0	0	0		7	0		0	1	0
7	0	7		0	7		0	1	0

7	0	7		0	7		0	1	0
0	0	0		7	0		0	1	0
0	0	7		7	7		0	1	0

//tla mali kvadrat
2	0	7		0	0		0	1	0
0	0	7		2	0		0	1	0
2	0	12		0	5		0	1	0

2	0	12		0	5		0	1	0
0	0	7		2	0		0	1	0
0	0	12		2	5		0	1	0

//tlazgoraj
7	1	7		0	0		0	1	0
2	1	7		14	0		0	1	0
7	1	12		0	14		0	1	0

7	1	12		0	14		0	1	0
2	1	7		14	0		0	1	0
2	1	12		14	14		0	1	0


//Stene glavna soba
//desno
0	0	12		0	0		1	0	0
0	0	0		12	0		1	0	0
0	2	12		0	2		1	0	0

0	2	12		0	2		1	0	0
0	0	0		12	0		1	0	0
0	2	0		12	2		1	0	0

//zadaj
0	0	0		0	0		0	0	1
7	0	0		7	0		0	0	1
0	2	0		0	2		0	0	1

0	2	0		0	2		0	0	1
7	0	0		7	0		0	0	1
7	2	0		7	2		0	0	1

//levo
7	0	0		0	0		0	0	1
7	0	7		7	0		0	0	1
7	2	0		0	2		0	0	1

7	2	0		0	2		0	0	1
7	0	7		7	0		0	0	1
7	2	7		7	2		0	0	1

//Mala pri rampi
2	0	12		0	0		1	0	0
0	0	12		2	0		1	0	0
2	2	12		0	2		1	0	0

2	2	12		0	2		1	0	0
0	0	12		2	0		1	0	0
0	2	12		2	2		1	0	0

//zgoraj naprej
7	1	12		0	0		1	0	0
2	1	12		5	0		1	0	0
7	2	12		0	1		1	0	0

7	2	12		0	1		1	0	0
2	1	12		5	0		1	0	0
2	2	12		5	1		1	0	0

//zgoraj levo
7	1	7		0	0		0	0	1
7	1	12		5	0		0	0	1
7	2	7		0	1		0	0	1

7	2	7		0	1		0	0	1
7	1	12		5	0		0	0	1
7	2	12		5	1		0	0	1

//Rampa stena
1.5	0	7.5		0	0		0	0	1
1.5	0	10		5	0		0	0	1
1.5	1	7.5		0	2		0	0	1

1.5	0	7		0	0		0	0	1
1.5	0	7.5		1	0		0	0	1
1.5	1	7		0	2		0	0	1

1.5 1	7		0	2		0	0	1
1.5	0	7.5		1	0		0	0	1
1.5	1	7.5		1	2		0	0	1

//Stena pri rampi
2	0	7		0	0		0	0	1
2	0	12		10	0		0	0	1
2	1	7		0	2		0	0	1

2	1	7		0	2		0	0	1
2	0	12		10	0		0	0	1
2	1	12		10	2		0	0	1

//Stena levo od rampe
7	0	7		0	0		0	0	1
1.5	0	7		10	0		0	0	1
7	1	7		0	2		0	0	1

7	1	7		0	2		0	0	1
1.5	0	7		10	0		0	0	1
1.5	1	7		10	2		0	0	1

//Rampa
2	1	7.5		0	0		0	1	1
1.5	1	7.5		1	0		0	1	1
2	0	10		0	5		0	1	1

2	0	10		0	5		0	1	1
1.5	1	7.5		1	0		0	1	1
1.5	0	10		1	5		0	1	1

2	1	7		0	0		0	1	0
1.5	1	7		1	0		0	1	0
2	1	7.5		0	1		0	1	0

2	1	7.5		0	1		0	1	0
1.5	1	7		1	0		0	1	0
1.5	1	7.5		1	1		0	1	0


//Nebo
//Glavna ploskev
32	25	-25		0	0		0	1	0
-25	25	-25		1	0		0	1	0
32	25	37		0	1		0	1	0

32	25	37		0	1		0	1	0
-25	25	-25		1	0		0	1	0
-25	25	37		1	1		0	1	0

//Stranske
//naprej
32	25	37		0	0		0	1	0
-25	25	37		0	1		0	1	0
32	5	47		1	0		0	1	0

32	5	47		1	0		0	1	0
-25	25	37		0	1		0	1	0
-25	5	47		1	1		0	1	0

//levo
32	25	-25		0	0		0	1	0
32	25	37		0	1		0	1	0
42	5	-25		1	0		0	1	0

42	5	-25		1	0		0	1	0
32	25	37		0	1		0	1	0
42	5	37		1	1		0	1	0

//Zadaj
-25	25	-25		0	0		0	1	0
32	25	-25		0	1		0	1	0
-25	5	-35		1	0		0	1	0

-25	5	-35		1	0		0	1	0
32	25	-25		0	1		0	1	0
32	5	-35		1	1		0	1	0

//Desno
-25	25	37		0	0		0	1	0
-25	25	-25		0	1		0	1	0
-35	5	37		1	0		0	1	0

-35	5	37		1	0		0	1	0
-25	25	-25		0	1		0	1	0
-35	5 -25		1	1		0	1	0

//Zapolnilni trikotniki
32	25	37		0	0		0	1	0
32	5	47		0	1		0	1	0
42	5	37		1	0		0	1	0

32	25	-25		0	0		0	1	0
42	5	-25		0	1		0	1	0
32	5	-35		1	0		0	1	0

-25	25	-25		0	0		0	1	0
-25	5	-35		0	1		0	1	0
-35	5	-25		1	0		0	1	0

-25	25	37		0	0		0	1	0
-35	5	37		1	0		0	1	0
-25	5	47		0	1		0	1	0


//Objekti v igri
//Skatla

//sprednja ploskev
0.2	0	0		0	0		0	0	-1
0	0	0		0	1		0	0	-1
0.2	0.2	0		1	0		0	0	-1

0.2	0.2	0		1	0		0	0	-1
0	0	0		0	1		0	0	-1
0	0.2	0		1	1		0	0	-1

//desna plockev
0	0	0		0	0		-1	0	0
0	0	0.2		0	1		-1	0	0
0	0.2	0		1	0		-1	0	0

0	0.2	0		1	0		-1	0	0
0	0	0.2		0	1		-1	0	0
0	0.2	0.2		1	1		-1	0	0

//	Zadnja ploskev
0	0	0.2		0	0		0	0	1
0.2	0	0.2		0	1		0	0	1
0	0.2	0.2		1	0		0	0	1

0	0.2	0.2		1	0		0	0	1
0.2	0	0.2		0	1		0	0	1
0.2	0.2	0.2		1	1		0	0	1

//Leva ploskev
0.2	0	0.2		0	0		1	0	0
0.2	0	0		0	1		1	0	0
0.2	0.2	0.2		1	0		1	0	0

0.2	0.2	0.2		1	0		1	0	0
0.2	0	0		0	1		1	0	0
0.2	0.2	0		1	1		1	0	0

//Spodnja ploskev
0.2	0	0.2		0	0		0	-1	0
0	0	0.2		0	1		0	-1	0
0.2	0	0		1	0		0	-1	0

0.2	0	0		1	0		0	-1	0
0	0	0.2		0	1		0	-1	0
0	0	0		1	1		0	-1	0

//Zgornja ploskev
0	0.2	0		0	0		0	1	0
0	0.2	0.2		0	1		0	1	0
0.2	0.2	0		1	0		0	1	0

0.2	0.2	0		1	0		0	1	0
0	0.2	0.2		0	1		0	1	0
0.2	0.2	0.2		1	1		0	1	0